Przez ułamek sekundy zawahał się, z ręką na klamce, czy nie zatrzasnąć okna, ale zanim zdążył to zrobić, dziwaczny kształt był już nad jedną z latarni oświetlających Privet Drive i Harry zdał sobie w końcu sprawę, co to jest, [[так что; поэтому; следовательно]] szybko odskoczył w bok.	więc
[[конечно]] chciała się upewnić, że tym razem dostaniesz coś od kogoś na urodziny. 	Chyba
[[на этот раз]] miał, między innymi, napisać paskudnie trudne wypracowanie na temat eliksirów powodujących kurczenie się ludzi i zwierząt, a dobrze wiedział, że gdyby zjawił się w Hogwarcie bez tego wypracowania, sprawiłby wielką przyjemność profesorowi Snape’owi, nauczycielowi eliksirów. 	Tym razem
Rozdarł papier i zobaczył coś zielonego i skórzanego, ale [[прежде тем, (не успел и ...)]] zdołał rozerwać całe opakowanie, paczka zadrżała dziwnie, a wewnątrz coś głośno kłapnęło — jakby miało szczęki.	zanim
Brak dostępu do ksiąg zaklęć był prawdziwym utrapieniem dla Harry’ego, [[потому что]] uczniowie Hogwartu musieli podczas wakacji odrobić sporo prac domowych. 	ponieważ
ciotka i wuj byli na niego wyjątkowo wściekli, [[потому что]] w tydzień po przyjeździe na wakacje zatelefonował do niego przyjaciel — a był nim, rzecz jasna, kolega ze Szkoły Magii i Czarodziejstwa.	ponieważ
Nie była ona, jak mu wmawiali przez dziesięć lat Dursleyowie, pozostałością po wypadku samochodowym, w którym mieli zginąć jego rodzice, [[потому что]] Lily i James Potterowie wcale nie zginęli w wypadku. 	ponieważ
Choć w ciągu ubiegłego roku Harry podrósł o parę cali, [[всё еще]] był dość niski i chudy jak na swój wiek. 	nadal
Mając nadzieję, że Dursleyowie [[всё еще]] mocno śpią, Harry osunął się na kolana i sięgnął pod biurko, żeby ją wyciągnąć.	nadal
[[остался]] już tylko list z Hogwartu.	Został
Harry, naprawdę [[Я сожалею]] z powodu tego telefonu. 	bardzo mi przykro
[[достаточно]] powiedzieć, że ze wszystkich pór roku najbardziej nienawidził letnich wakacji, a można też dodać, że naprawdę chciał odrobić wszystkie prace domowe zadane na lato, ale musiał się tym zajmować w tajemnicy, kiedy wszyscy już spali. 	Wystarczy
Harry [["даже слишком хорошо"]] pamiętał moment, w którym połamała się stara różdżka Rona. 	aż za dobrze
Ona [[также]] przydźwigała pakunek i sprawiała wrażenie bardzo z siebie zadowolonej. 	również
Teraz, stojąc w ciemnym oknie, wspomniał ich ostatnie starcie i musiał przyznać, że miał wielkie szczęście, [[коли, раз]] udało mu się dożyć tych trzynastych urodzin.	skoro
[[только]] teraz zdał sobie sprawę z tego, że od godziny ma już trzynaście lat.	Dopiero
[[только]] po kilku sekundach uświadomił sobie, że zobaczył coś dziwnego.	Dopiero
Harry [[немедленно]] rozpoznał tego ptaka — był to sędziwy puchacz Errol, należący do rodziny Weasleyów. 	natychmiast
Mam nadzieję że mugole traktują cię jak [[подобает]].	należy
Wiedział, że Hagrid nie przysłałby mu świadomie niczego niebezpiecznego, ale wiedział też, że Hagrid ma [[совершенно]] inne pojęcie o tym, co jest niebezpieczne, od większości normalnych ludzi. 	zupełnie
Harry nie martwił się o nią — już nie raz znikała na tak długo — miał jednak nadzieję, że [[скоро]] powróci. 	wkrótce
Może udałoby się nam tam [[встретиться]]?	spotkać
ale [[вдруг]] pojawiła się Hedwiga! 	nagle
W drugiej ręce trzymał swoje orle pióro, którego koniuszkiem wodził po tekście, szukając czegoś, co pomogłoby mu w napisaniu rozprawki na temat: „Palenie czarownic w XIV wieku było [[полностью]] bezsensowne”.	całkowicie
Kiedy odwiązał paczkę, dziobnęła go przyjacielsko, po czym pofrunęła do swojej klatki, sadowiąc się [[возле]] Errola.	obok
Tak się bowiem złożyło, że profesor Snape nie znosił Harry’ego i z najwyższą ochotą skorzystałby z każdej [[возможности]], by go ukarać miesięcznym szlabanem. 	okazji
Chyba chciała się upewnić, że tym razem [[получишь]] coś od kogoś na urodziny. 	dostaniesz
Harry spotkał się jednak z nim [[снова]] w Hogwarcie. 	ponownie
szepnął Harry, otwierając neseser, aby zajrzeć [[внутрь]].	do środka
Na przykład Czarownica Wendelina, zwana również Dziwożoną, tak polubiła te łaskotki, że przybierała [[всё; всё больше]] to nowe postacie, aby dać się schwytać i spalić. 	coraz
Zamarł bez ruchu, obserwując, jak dziwny kształt szybuje [[всё; всё больше]] niżej i niżej. 	coraz
Wracamy [[за неделю до]] początkiem semestru. 	na tydzień przed
Brak dostępu do ksiąg zaklęć był prawdziwym utrapieniem dla Harry’ego, ponieważ uczniowie Hogwartu musieli podczas wakacji odrobić [[довольно много]] prac domowych. 	sporo
ponieważ Lily i James Potterowie wcale nie zginęli w [[аварии]]. 	wypadku
[[Держу пари]] się, że mnóstwo się tam nauczy. 	Założę
Tym razem miał, między innymi, napisać paskudnie trudne wypracowanie na temat eliksirów powodujących kurczenie się ludzi i zwierząt, a dobrze wiedział, że gdyby zjawił się w Hogwarcie bez tego wypracowania, sprawiłby wielką [[удовольствие]] profesorowi Snape’owi, nauczycielowi eliksirów. 	przyjemność
Większość poszła na ten wyjazd, ale trochę zostało i rodzice [[должны купить мне]] nową różdżkę.	mają mi kupić
W [[прошлым]] tygodniu dostał list.	zeszłym
Było w [[прошлым]] tygodniu. 	zeszłym
Rozdarł papier i zobaczył coś zielonego i skórzanego, ale zanim zdołał rozerwać całe opakowanie, paczka zadrżała dziwnie, a [[внутри]] coś głośno kłapnęło — jakby miało szczęki.	wewnątrz
Ale jak tu [[убедить]] wuja Vernona lub ciotkę Petunię, żeby podpisali formularz?	przekonać
Kupiłam ci prezent [[через]] sowią pocztę wysyłkową znalazłam takie ogłoszenie w „Proroku Codziennym” (kazałam go sobie tutaj przysyłać, żeby wiedzieć, co się dzieje w czarodziejskim świecie). 	poprzez
Ostatnio bardzo mu zależało na unikaniu awantur, bo ciotka i wuj byli na niego wyjątkowo wściekli, ponieważ w tydzień po przyjeździe na wakacje zatelefonował do niego przyjaciel — a był nim, [[конечно]], kolega ze Szkoły Magii i Czarodziejstwa.	rzecz jasna
Tak myślę że może będzie ci to pasować w [[будущем]] roku. 	przyszłym
[[я хочу]] przypomnieć, że nowy rok szkolny rozpoczyna się 1 września. 	pragnę
Musiał tylko [[заботиться]], żeby nie poplamić pościeli atramentem, 	uważać
[[Жертвы]] rzucały proste zaklęcie zmrożenia płomieni i udawały, że wrzeszczą z bólu, podczas gdy w rzeczywistości odczuwały przyjemne łaskotanie. 	Ofiary
Trzeciej sowy, o pięknym brązowym upierzeniu, Harry nigdy [[раньше]] nie widział, ale od razu poznał, skąd przyleciała, bo prócz trzeciej paczki przyniosła list z godłem Hogwartu. 	przedtem
[[произошло]] się to wtedy, kiedy obaj polecieli do Hogwartu samochodem, który przy lądowaniu trafił w drzewo rosnące pośrodku szkolnych błoni.	Zdarzyło
Voldemort umknął, [[едва]] żywy, pozbawiony swej mocy…	ledwo
Nie zmieniły się jego kruczoczarne włosy — zawsze [[ужасно]] rozczochrane, bez względu na to, co z nimi robił. 	okropnie
 gdyby ktoś z rodziny Dursleyów, idąc do [[ванная / туалет]], usłyszał skrzypienie pióra, groziłoby mu zamknięcie w komórce pod schodami na całą resztę lata.	łazienki
PROSZĘ [[держаться на расстоянии от]] MOJEJ RODZINY!	trzymać się z dala od
mordercze zaklęcie Voldemorta odbiło się od niego, godząc w tego, który je [[швырнул, кинул, наложил (заклинание)]]. 	rzucił
Na nieszczęście [[попал, встретил, столкнулся с]] na wuja Vernona.	trafił
Sięgnął po lampę stojącą na szafce nocnej, chwycił ją mocno i uniósł nad głową, gotów [[ударить]]. 	uderzyć
Wiedział, że Hagrid nie przysłałby mu świadomie niczego niebezpiecznego, ale wiedział też, że Hagrid ma zupełnie inne [[понятие]] o tym, co jest niebezpieczne, od większości normalnych ludzi. 	pojęcie
Małe oczka wuja Vernona błyskawicznie przeniosły się na Harry’ego, któremu nogi wrosły w [[пол]].	podłogę
Książka zsunęła się z łóżka, spadła z trzaskiem na [[пол]] i popełzła po niej szybko. 	podłogę
Mam nadzieję, że nie jest [[слишком длинное]] — dwa zwoje pergaminu więcej, niż życzył sobie profesor Binns.	za długie
Harry był świetnym graczem: został najmłodszym w ostatnim stuleciu [[участником, членом (команды)]] reprezentacji jednego z domów Hogwartu. 	członkiem
Chyba chciała [[удостоверить(ся)]], że tym razem dostaniesz coś od kogoś na urodziny. 	się upewnić
Potem [[схватил]] za resztę brązowego papieru i pociągnął.Z opakowania wypadła… książka. Harry zdążył tylko zauważyć ładną zieloną okładkę i złoty napis: Potworna księga potworów, gdy książka podskoczyła i zaczęła pełznąć po łóżku jak dziwaczny krab.	złapał
Musiał tylko uważać, żeby nie poplamić pościeli atramentem, ponieważ [[тогда]] wszystko by się wydało.	wówczas
Ostatnio bardzo mu zależało na unikaniu awantur, bo ciotka i wuj byli na niego [[сугубо, исключительно]] wściekli, 	wyjątkowo
Ciszę nocy przerywało tylko odległe chrapanie jego [[сугубо, исключительно]] tłustego kuzyna, Dudleya. „	wyjątkowo
Ron wrzeszczał tak głośno, że wuj Vernon aż podskoczył i oddalił [[трубку (телефона)]] od ucha, wpatrując się w nią z mieszaniną złości i strachu.	słuchawkę
zmutowanych szkieletów mugoli, którzy włamali się do środka i którym powyrastały [[дополнительные]] głowy i różne inne świństwa.Nie mogłem uwierzyć, że mój tata wygrał w loterii „Proroka”. Siedemset galeonów! Większość poszła na ten wyjazd, ale trochę zostało i rodzice mają mi kupić nową różdżkę.	dodatkowe
Harry zdążył tylko [[уведомление]] ładną zieloną okładkę i złoty napis: Potworna księga potworów, gdy książka podskoczyła i zaczęła pełznąć po łóżku jak dziwaczny krab.	zauważyć
Kiedy w pobliżu znajduje się ktoś niegodny [[доверия]], wykrywacz podobno błyska i wiruje. 	zaufania
Harry był [[превосходным]] graczem: został najmłodszym w ostatnim stuleciu członkiem reprezentacji jednego z domów Hogwartu. 	świetnym
ryknął, teraz trzymając słuchawkę na odległość wyciągniętej ręki, jakby się bał, że [[взорвётся]]. — 	wybuchnie
ryknął, teraz trzymając słuchawkę na [[расстояние]] wyciągniętej ręki, jakby się bał, że wybuchnie. — 	odległość
Choć w ciągu ubiegłego roku Harry podrósł o parę [[дюймов]], nadal był dość niski i chudy jak na swój wiek. 	cali
Harry zdążył tylko zauważyć [[красивую]] zieloną okładkę i złoty napis: Potworna księga potworów, gdy książka podskoczyła i zaczęła pełznąć po łóżku jak dziwaczny krab.	ładną
Serce mu zabiło mocno, kiedy rozerwał papier i ujrzał błyszczący neseser z czarnej skóry, ze srebrnym napisem: „Podręczny [[набор]] miotlarski”.	zestaw
Hedwiga i Errol obserwowali z zainteresowaniem, jak Harry ściska w ramionach wyrywającą się książkę, [[бежит]] z nią do komody, wyciąga skórzany pasek i zaciska go mocno wokół książki. 	biegnie
sąsiedztwie zwrócili uwagę), Harry zszedł po cichu na dół, wyłamał zamek w drzwiach komórki pod schodami, [[украл]] kilka książek i ukrył je w swojej sypialni. 	porwał
Znany był z tego, że przyjaźnił się z olbrzymimi pająkami, kupował groźne trójgłowe psy od ludzi spotkanych [[случайно]] w pubie, a raz przemycił do swojej chatki jajo smoka, co było sprzeczne z prawami obowiązującymi w świecie czarodziejów.	przypadkowo
[[кроме]] przyjaciół Harry’emu najbardziej brakowało quidditcha, najpopularniejszej dyscypliny sportowej w magicznym świecie — bardzo niebezpiecznej i bardzo podniecającej, w którą grało się na latających miotłach. 	Prócz
Wuj Vernon uległ jego prośbom, bo harmider, jaki wyprawiała Hedwiga, kiedy była zamknięta w klatce przez całą [[день]], był nie do zniesienia.	dobę
Kupiłam ci prezent poprzez sowią pocztę wysyłkową znalazłam takie [[объявление]] w „Proroku Codziennym” (kazałam go sobie tutaj przysyłać, żeby wiedzieć, co się dzieje w czarodziejskim świecie). 	ogłoszenie
szepnął Harry, otwierając neseser, aby [[посмотреть]] do środka.	zajrzeć
Szklany bąk sam ustawił się pionowo na spiczastym końcu i tkwił tak nieruchomo, odbijając fosforyzujące [[стрелки (будильника)]] budzika. 	wskazówki
[[радостный]] pan Weasley powiedział naszemu reporterowi: „Za te pieniądze pojedziemy do Egiptu, gdzie nasz najstarszy syn, Bill, pracuje dla banku Gringotta jako łamacz uroków”.	Zachwycony
Tak się [[потому что]] złożyło, że profesor Snape nie znosił Harry’ego i z najwyższą ochotą skorzystałby z każdej okazji, by go ukarać miesięcznym szlabanem. 	bowiem
Ptak otworzył jedno mętne oko, zagruchał słabo w podzięce i zanurzył [[клюв]] w miseczce z wodą.	dziób
Na [[фоне]] złotego księżyca czerniało coś wielkiego i koślawego. 	tle
Ron [[по-видимому]] zrozumiał, że wpędził Harry’ego w kłopoty, bo już więcej nie zadzwonił. 	najwidoczniej
Przypiął sobie [[значок]] naczelnego prefekta do fezu, tkwiącego mu zawadiacko na głowie, na schludnie zaczesanych włosach. 	odznakę
Ministerstwie Magii, zgarnął najwyższą [[выигрыш]] w dorocznej loterii „Proroka Codziennego”.Zachwycony pan Weasley powiedział naszemu reporterowi: „Za te pieniądze pojedziemy do Egiptu, gdzie nasz najstarszy syn, Bill, pracuje dla banku Gringotta jako łamacz uroków”.Rodzina Weasleyów spędzi w Egipcie cały miesiąc. Wrócą na początek nowego roku szkolnego w Hogwarcie, gdzie uczy się pięcioro dzieci Weasleyów.	wygraną
 groziłoby mu zamknięcie w komórce pod [[лестница]] na całą resztę lata.	schodami
[[заместитель]] dyrektora	zastępca
Harry nie martwił się o nią — już nie raz znikała na tak długo — miał jednak nadzieję, że wkrótce [[вернётся]]. 	powróci
Uznawszy, że będzie się o to [[волноваться]] rano, wrócił do łóżka i przekreślił kolejny dzień na karcie, na której odliczał dni dzielące go od powrotu do Hogwartu. 	martwił
Ekspres do Hogwartu [[отбывает]] z dworca King’s Cross, z peronu dziewięć i trzy czwarte, o godzinie jedenastej.	odjeżdża
Awantura, która potem [[взорвалась]], należała do najgorszych, jakie miały miejsce w tym domu, a było ich już wiele.	wybuchła
Aż mnie [[зависть, ревность]] bierze — ci starożytni czarodzieje egipscy byli naprawdę super.	zazdrość
Sponad okularów połyskiwały jasnozielone oczy, a na czole prześwitywała przez włosy cienka blizna w [[форме]] błyskawicy.	kształcie
Byli mugolami, a do magii mieli [[отношение]] bardzo średniowieczny. 	stosunek
Hedwiga i Errol obserwowali z zainteresowaniem, jak Harry ściska w ramionach wyrywającą się książkę, biegnie z nią do komody, wyciąga skórzany [[ремешок]] i zaciska go mocno wokół książki. 	pasek
krzyknął Ron, jakby wuj Vernon stał na drugim końcu [[поле]] do piłki nożnej. — 	boiska
ryknął, teraz [[держа]] słuchawkę na odległość wyciągniętej ręki, jakby się bał, że wybuchnie. — 	trzymając
Uczniowie trzeciej klasy mogą w określone soboty i niedziele [[посетить]] wioskę Hogsmeade. 	odwiedzać
Harry [[поднял]] wycinek, wygładził go i przeczytał:	podniósł
Harry [[успел]] tylko zauważyć ładną zieloną okładkę i złoty napis: Potworna księga potworów, gdy książka podskoczyła i zaczęła pełznąć po łóżku jak dziwaczny krab.	zdążył
Mam nadzieję że mugole [[обходятся с тобой]] jak należy.	traktują cię
Harry nie [[волновался]] o nią — już nie raz znikała na tak długo — miał jednak nadzieję, że wkrótce powróci. 	martwił się
Tym razem miał, między innymi, napisać [[отвратительно]] trudne wypracowanie na temat eliksirów powodujących kurczenie się ludzi i zwierząt, a dobrze wiedział, że gdyby zjawił się w Hogwarcie bez tego wypracowania, sprawiłby wielką przyjemność profesorowi Snape’owi, nauczycielowi eliksirów. 	paskudnie
Oznaczało to, że znał się dobrze na wielu sprawach, o których Harry [[Он понятия не имел,]], ale jeszcze nigdy w życiu nie korzystał z telefonu. 	nie miał zielonego pojęcia
Jednym z jego największych [[сокровищ]] była miotła wyścigowa Nimbus Dwa Tysiące.Odłożył skórzany neseser i sięgnął po ostatnią paczkę. Od razu rozpoznał koślawe pismo na brązowym papierze: to paczka od Hagrida, gajowego Hogwartu. Rozdarł papier i zobaczył coś zielonego i skórzanego, ale zanim zdołał rozerwać całe opakowanie, paczka zadrżała dziwnie, a wewnątrz coś głośno kłapnęło — jakby miało szczęki.	skarbów
pragnę przypomnieć, że nowy rok szkolny [[начинается]] 1 września. 	rozpoczyna się
Na przykład Czarownica Wendelina, zwana również Dziwożoną, tak polubiła te łaskotki, że przybierała coraz to nowe postacie, aby dać się [[поймать]] i spalić. 	schwytać
Do jej nóżek przywiązana była [[большая]] paczka.Harry natychmiast rozpoznał tego ptaka — był to sędziwy puchacz Errol, należący do rodziny Weasleyów. Podbiegł do łóżka, odwiązał sznurek, którym przymocowana była paczka, i zaniósł Errola do klatki Hedwigi. Ptak otworzył jedno mętne oko, zagruchał słabo w podzięce i zanurzył dziób w miseczce z wodą.	spora
Sponad okularów połyskiwały jasnozielone oczy, a na [[лбу]] prześwitywała przez włosy cienka blizna w kształcie błyskawicy.	czole
Rozmawiałem z ojcem, powiedział, że nie powinienem tak [[орать]].	wrzeszczeć
Harry zajął się [[остальными]] ptakami. 	pozostałymi
Harry zdążył tylko zauważyć ładną zieloną okładkę i złoty napis: Potworna księga [[чудовищ]], gdy książka podskoczyła i zaczęła pełznąć po łóżku jak dziwaczny krab.	potworów
[[лишенный]] swej mocy…Harry spotkał się jednak z nim ponownie w Hogwarcie. Teraz, stojąc w ciemnym oknie, wspomniał ich ostatnie starcie i musiał przyznać, że miał wielkie szczęście, skoro udało mu się dożyć tych trzynastych urodzin.	pozbawiony
Kiedy [[освобожденный]] ją od listu i paczki, nastroszyła z godnością pióra, zamachała skrzydłami i natychmiast wyleciała z powrotem przez otwarte okno.Harry usiadł na łóżku, sięgnął po paczkę, którą przyniósł Errol, i rozerwał brązowy papier. Wewnątrz była jego pierwsza w życiu kartka urodzinowa i prezent owinięty złotą folią. Kiedy otwierał kopertę, ręce lekko mu drżały. Na łóżko wypadł list i wycinek z gazety.	uwolnił
Potem [[снял]] okulary, położył się i jeszcze raz zerknął na swoje trzy kartki urodzinowe.	zdjął
Sponad okularów połyskiwały jasnozielone oczy, a na czole prześwitywała przez włosy cienka [[рубец]] w kształcie błyskawicy.	blizna
[[убеждение]] Hagrida, że gryząca książka może mu „pasować”, wydało się Harry’emu złowieszcze, ale położył jego kartkę obok listów Rona i Hermiony, uśmiechając się jeszcze szerzej. 	Przekonanie
krzyknął Ron, jakby wuj Vernon stał na drugim końcu boiska do [[футбол]]. — 	piłki nożnej
Wuj Vernon uległ jego prośbom, bo harmider, jaki wyprawiała Hedwiga, kiedy była zamknięta w klatce przez całą dobę, był [[невыносимый]].	nie do zniesienia
[[уважаемый]] Panie Potter,	Szanowny
Harry ruszył za nią ukradkiem, aż schowała się w ciemnym [[углу]] pod biurkiem. 	kącie
Znany był z tego, że przyjaźnił się z olbrzymimi pająkami, kupował groźne trójgłowe psy od ludzi spotkanych przypadkowo w pubie, a raz przemycił do swojej chatki jajo smoka, co było [[против]] z prawami obowiązującymi w świecie czarodziejów.	sprzeczne
Znany był z tego, że przyjaźnił się z olbrzymimi pająkami, [[покупал]] groźne trójgłowe psy od ludzi spotkanych przypadkowo w pubie, a raz przemycił do swojej chatki jajo smoka, co było sprzeczne z prawami obowiązującymi w świecie czarodziejów.	kupował
zmutowanych szkieletów mugoli, którzy włamali się do środka i którym powyrastały dodatkowe głowy i różne inne [[гадости]].Nie mogłem uwierzyć, że mój tata wygrał w loterii „Proroka”. Siedemset galeonów! Większość poszła na ten wyjazd, ale trochę zostało i rodzice mają mi kupić nową różdżkę.	świństwa
Tym razem miał, między innymi, napisać paskudnie trudne [[сочинение]] na temat eliksirów powodujących 	wypracowanie
Skończę [[сочинение]] jutro w nocy…”	wypracowanie
Jedną z niezwykłych [[черты]] Harry’ego było i to, że nigdy nie wyczekiwał z utęsknieniem swoich urodzin. 	cech
Dwa ostatnie lata Harry spędził w Hogwarcie, Szkole Magii i Czarodziejstwa, wracając na Privet Drive tylko na letnie wakacje, podczas których Dursleyowie żyli w [[непрерывный]] strachu, że ktoś z sąsiadów dowie się, jakiego dziwoląga mają pod swoim dachem. 	ciągłym
Harry [[подозревал]], że to Ron ją ostrzegł, żeby nie dzwoniła, a szkoda, ponieważ rodzice Hermiony, najinteligentniejszej czarownicy w klasie Harry’ego, byli mugolami, więc musiała dobrze wiedzieć, jak się korzysta z telefonu, no i miała dość rozsądku, by na wstępie nie palnąć, 	podejrzewał
Znając Hermionę, [[подозревал]], że to jakaś wielka księga wyjątkowo trudnych zaklęć — ale się mylił. 	podejrzewał
Na przykład Czarownica Wendelina, zwana również Dziwożoną, tak polubiła te łaskotki, że przybierała coraz to nowe [[облик]], aby dać się schwytać i spalić. 	postacie
Rozdarł papier i zobaczył coś zielonego i skórzanego, ale zanim zdołał rozerwać całe opakowanie, paczka zadrżała dziwnie, a wewnątrz coś głośno kłapnęło — jakby miało [[челюсти]].	szczęki
Znając Hermionę, podejrzewał, że to jakaś wielka księga wyjątkowo trudnych zaklęć — ale [[был неправ, ошибался]]. 	się mylił
Ludzie niemagiczni (znani bardziej jako mugole) lękali się magii szczególnie w czasach średniowiecznych, prawdopodobnie dlatego, że niewiele o niej wiedzieli i nie [[могли]] rozpoznawać jej przejawów. 	potrafili
Wiedział, że Hagrid nie przysłałby mu [[сознательно]] niczego niebezpiecznego, ale wiedział też, że Hagrid ma zupełnie inne pojęcie o tym, co jest niebezpieczne, od większości normalnych ludzi. 	świadomie
Harry [[схватил]] pióro w zęby i sięgnął pod poduszkę, gdzie miał schowany kałamarz i zwój pergaminu. 	chwycił
Harry poczuł dziwny [[сокращение]] w żołądku. 	skurcz
W drugiej ręce trzymał swoje orle pióro, którego koniuszkiem wodził po tekście, szukając czegoś, co pomogłoby mu w napisaniu rozprawki na temat: „Palenie czarownic w XIV wieku było całkowicie [[бессмысленный]]”.	bezsensowne
Harry, to jest kieszonkowy fałszoskop — [[детектор]] podstępów. 	wykrywacz
Harry Potter był niezwykłym chłopcem, ale w tym momencie czuł się jak każdy normalny człowiek — po raz pierwszy w życiu [[радовался, был рад]], że ma urodziny.	cieszył się
Małe oczka wuja Vernona [[в мгновение ока]] przeniosły się na Harry’ego, któremu nogi wrosły w podłogę.	błyskawicznie
Harry chwycił pióro w zęby i sięgnął pod poduszkę, gdzie miał schowany kałamarz i [[свиток]] pergaminu. 	zwój
Ostatnio bardzo mu zależało na unikaniu awantur, bo ciotka i wuj byli na niego wyjątkowo [[злы]], ponieważ w tydzień po przyjeździe na wakacje zatelefonował do niego przyjaciel — a był nim, rzecz jasna, kolega ze Szkoły Magii i Czarodziejstwa.	wściekli
Przebiegał [[взглядом]] gwiaździste niebo, wypatrując Hedwigi, która w każdej chwili mogła przyfrunąć z martwą myszą w dziobie, żądna pochwały. 	spojrzeniem
Potem wyprostował się i przeciągnął, zerkając na [[будильник]] stojący na nocnej szafce.	budzik
Tak więc Harry nie miał żadnej wiadomości od swych przyjaciół czarodziejów przez pięć długich tygodni i to lato zapowiadało się prawie równie [[дрянное]], jak poprzednie. 	podle
Mam nadzieję, że nie jest za długie — dwa zwoje pergaminu więcej, niż [[желал]] sobie profesor Binns.	życzył
Oparł się o parapet, czując chłodny [[дыхание]] na twarzy, tak miły po duszeniu się pod kocem. 	powiew
Od czasu do czasu udawało im się schwytać prawdziwą czarownicę lub czarodzieja, ale nie mieli pojęcia, że palenie ich na [[куча (нп. дров)]] jest zupełnie bezsensowne. 	stosie
Potem złapał za resztę brązowego papieru i [[потянул]].Z opakowania wypadła… książka. Harry zdążył tylko zauważyć ładną zieloną okładkę i złoty napis: Potworna księga potworów, gdy książka podskoczyła i zaczęła pełznąć po łóżku jak dziwaczny krab.	pociągnął
Wuj Vernon [[снизошёл]] jego prośbom, bo harmider, jaki wyprawiała Hedwiga, kiedy była zamknięta w klatce przez całą dobę, był nie do zniesienia.	uległ
Był tam wielki słój wybornej pasty Fleetwooda do polerowania rączki miotły, para lśniących, srebrnych klipsów do spinania gałązek, maleńki mosiężny kompas z uchwytem do rączki, bardzo [[полезный]] podczas długich lotów, a także Poradnik samodzielnej konserwacji mioteł.	użyteczny
Harry’ego, a środkowa sowa, wielka i [[серый]], przewróciła się na grzbiet i legła bez ruchu. 	szara
Sponad okularów połyskiwały jasnozielone oczy, a na czole prześwitywała przez włosy [[тонкий]] blizna w kształcie błyskawicy.	cienka
Dlatego na początku wakacji zamknęli w komórce pod schodami jego księgi [[заклятий]], różdżkę, kociołek i miotłę i zabronili mu rozmawiać z sąsiadami.	zaklęć
Choć w ciągu [[прошедшего]] roku Harry podrósł o parę cali, nadal był dość niski i chudy jak na swój wiek. 	ubiegłego
PS Percy został [[главным]] prefektem. 	naczelnym
Uczniowie trzeciej klasy mogą w [[определённые]] soboty i niedziele odwiedzać wioskę Hogsmeade. 	określone
Mam nadzieję, że nie [[досталось]] za to od twoich mugoli. 	oberwałeś
Dopiero teraz [[дал себе отчёт]] z tego, że od godziny ma już trzynaście lat.	zdał sobie sprawę
Nie wiedział jednak, że Fred i George [[(в)бросили]] mu kilka żuków do zupy.	wrzucili
Nikt chyba nie zasługiwał bardziej na wygranie stosu złotych monet od Weasleyów, którzy byli [[отличными]] ludźmi, a przy tym bardzo ubogimi. 	wspaniałymi
Harry chwycił pióro w zęby i [[дотянулся до, взял, достиг]] pod poduszkę, gdzie miał schowany kałamarz i zwój pergaminu. 	sięgnął
[[дотянулся до, взял, достиг]] po lampę stojącą na szafce nocnej, chwycił ją mocno i uniósł nad głową, gotów uderzyć. 	sięgnął
Mając nadzieję, że Dursleyowie nadal mocno śpią, Harry osunął się na kolana i [[дотянулся до, взял, достиг]] pod biurko, żeby ją wyciągnąć.	sięgnął
Hedwiga i Errol obserwowali z zainteresowaniem, jak Harry [[сдавливает]] w ramionach wyrywającą się książkę, biegnie z nią do komody, wyciąga skórzany pasek i zaciska go mocno wokół książki. 	ściska
Wewnątrz było coś, co przypominało miniaturowego szklanego [[волчок, юлу]] do zabawy, i jeszcze jedna karteczka od Rona.	bąka
Przez [[доля]] sekundy zawahał się, z ręką na klamce, czy nie zatrzasnąć okna, ale zanim zdążył to zrobić, dziwaczny kształt był już nad jedną z latarni oświetlających Privet Drive i Harry zdał sobie w końcu sprawę, co to jest, więc szybko 	ułamek
Wystarczy powiedzieć, że ze wszystkich pór roku najbardziej nienawidził letnich wakacji, a można też dodać, że naprawdę chciał [[сделать (домашнее задание)]] wszystkie prace domowe zadane na lato, ale musiał się tym zajmować w tajemnicy, kiedy wszyscy już spali. 	odrobić
Nie było też żadnych wiadomości od Hermiony Granger, która również należała do [[группа]] jego najlepszych przyjaciół w Hogwarcie. 	grona
Ron [[кричал, верещал]] tak głośno, że wuj Vernon aż podskoczył i oddalił słuchawkę od ucha, wpatrując się w nią z mieszaniną złości i strachu.	wrzeszczał
Oparł się o parapet, czując chłodny powiew na twarzy, tak miły po duszeniu się pod [[одеяло]]. 	kocem
Harry wyciągnął formularz pozwolenia i [[посмотрел]] mu się, tym razem już bez uśmiechu. 	przyjrzał
Jak dotąd, nie przynosiło to spodziewanego rezultatu, co wywoływało w nich [[неистовство]]. 	furię
Hedwiga i Errol [[наблюдали]] z zainteresowaniem, jak Harry ściska w ramionach wyrywającą się książkę, biegnie z nią do komody, wyciąga skórzany pasek i zaciska go mocno wokół książki. 	obserwowali
Harry rzucił okiem na [[подвижное]] zdjęcie i uśmiechnął się szeroko, kiedy zobaczył wszystkich dziewięcioro Weasleyów na tle wielkiej piramidy, wymachujących do niego rękami. 	ruchome
PRACOWNIK MINISTERSTWA MAGII [[урывает (выигрывает)]] NAJWYŻSZĄ WYGRANĄ	ZGARNIA
Harry podniósł list od Rona i [[развернул]] go.	rozwinął
Zostali zamordowani, a ich zabójcą był [[наимогущественнейший]] od stu lat czarnoksiężnik, Lord Voldemort. 	najpotężniejszy
Harry Potter był niezwykłym chłopcem, a owa blizna była jego najbardziej osobliwą [[чертой, особенностью]]. 	cechą
Harry zdążył tylko zauważyć ładną zieloną okładkę i złoty napis: [[чудовичная]] księga potworów, gdy książka podskoczyła i zaczęła pełznąć po łóżku jak dziwaczny krab.	Potworna
Dlatego na początku wakacji zamknęli w komórce pod schodami jego księgi zaklęć, [[палочка]], kociołek i miotłę i zabronili mu rozmawiać z sąsiadami.	różdżkę
Załączam listę książek [[необходимых]] w nowym roku szkolnym.	niezbędnych
Artur Weasley, kierownik Urzędu Niewłaściwego Użycia Produktów Mugoli w Ministerstwie Magii, [[Он ломал]] najwyższą wygraną w dorocznej loterii „Proroka Codziennego”.	zgarnął
Wuj Vernon, ciotka Petunia i ich syn Dudley byli jedynymi żyjącymi [[родственники]] Harry’ego. 	krewnymi
Kiedy pewnego dnia wuj Vernon, ciotka Petunia i Dudley wyszli z domu, by podziwiać nowy [[служебный]] samochód wuja Vernona (a robili to bardzo głośno, żeby wszyscy w sąsiedztwie zwrócili uwagę), Harry zszedł po cichu na dół, wyłamał zamek w drzwiach komórki pod schodami, porwał kilka książek i ukrył je w swojej sypialni. 	służbowy
Bill oprowadza nas po tych wszystkich starożytnych grobowcach, nie masz pojęcia, jakie zaklęcia ich [[стерегут]]! 	strzegą
Dochodziła północ, a Harry leżał na brzuchu w swoim łóżku, pod kocami naciągniętymi na głowę jak namiot, z latarką w ręku i wielką, oprawioną w skórę księgą (Historia magii Bathildy Bagshot) [[опяртой]] o poduszkę. 	opartą
Szklany bąk sam ustawił się pionowo na spiczastym końcu i [[застрял, застыл]] tak nieruchomo, odbijając fosforyzujące wskazówki budzika. 	tkwił
Ofiary rzucały proste zaklęcie zmrożenia płomieni i udawały, że [[кричат]] z bólu, podczas gdy w rzeczywistości odczuwały przyjemne łaskotanie. 	wrzeszczą
Dochodziła północ, a Harry leżał na brzuchu w swoim łóżku, pod kocami naciągniętymi na głowę jak namiot, z [[фонарик]] w ręku i wielką, oprawioną w skórę księgą (Historia magii Bathildy Bagshot) opartą o poduszkę. 	latarką
Odłożył [[кожаный]] neseser i sięgnął po ostatnią paczkę. 	skórzany
Bill mówi, że to tandeta dla turystów, bo wczoraj [[волчок, юла]] zaczął ni stąd, ni zowąd błyskać podczas kolacji. 	bąk
Ona również przydźwigała [[пакет]] i sprawiała wrażenie bardzo z siebie zadowolonej. 	pakunek
Był tam wielki [[банка]] wybornej pasty Fleetwooda do polerowania rączki miotły, para lśniących, srebrnych klipsów do spinania gałązek, maleńki mosiężny kompas z uchwytem do rączki, bardzo użyteczny podczas długich lotów, a także Poradnik samodzielnej konserwacji mioteł.	słój
Harry’emu udało się wyjść z tej [[столкновения]] jedynie z ową blizną na czole; mordercze zaklęcie Voldemorta odbiło się od niego, godząc w tego, który je rzucił. 	potyczki
Był tam wielki słój wybornej pasty Fleetwooda do polerowania rączki miotły, para lśniących, srebrnych klipsów do spinania gałązek, maleńki mosiężny kompas z uchwytem do rączki, bardzo użyteczny podczas długich lotów, a także [[руководство]] samodzielnej konserwacji mioteł.	Poradnik
[[С уважением]]	Z wyrazami szacunku
Uznawszy, że będzie się o to martwił rano, wrócił do łóżka i przekreślił kolejny dzień na karcie, na której odliczał dni [[отделяющие]] go od powrotu do Hogwartu. 	dzielące
Uznawszy, że będzie się o to martwił rano, wrócił do łóżka i przekreślił kolejny dzień na karcie, na której [[отсчитывал]] dni dzielące go od powrotu do Hogwartu. 	odliczał
Uznawszy, że będzie się o to martwił rano, wrócił do łóżka i [[зачеркнул]] kolejny dzień na karcie, na której odliczał dni dzielące go od powrotu do Hogwartu. 	przekreślił
[[признав]], że będzie się o to martwił rano, wrócił do łóżka i przekreślił kolejny dzień na karcie, na której odliczał dni dzielące go od powrotu do Hogwartu. 	Uznawszy
[[Прилагаю, прикладываю]] listę książek niezbędnych w nowym roku szkolnym.	Załączam
Proszę przekazać rodzicom lub opiekunowi do podpisania [[приложенное]] pozwolenie.	dołączone
Księga potworów zadygotała [[дико]], ale nie mogła już podskakiwać i kłapać okładkami, więc Harry cisnął ją na łóżko i sięgnął po kartkę od Hagrida.	wściekle
Księga potworów [[задрожала]] wściekle, ale nie mogła już podskakiwać i kłapać okładkami, więc Harry cisnął ją na łóżko i sięgnął po kartkę od Hagrida.	zadygotała
Książka chapnęła go w rękę, po czym przemknęła obok niego, wciąż [[хлопая, щёлкая]] okładkami. 	kłapiąc
Książka [[хапнула]] go w rękę, po czym przemknęła obok niego, wciąż kłapiąc okładkami. 	chapnęła
— Uoooo… — [[пробормотал]] Harry.	mruknął
Harry zdążył tylko zauważyć ładną zieloną okładkę i złoty napis: Potworna księga potworów, gdy książka podskoczyła i zaczęła [[ползать]] po łóżku jak dziwaczny krab.	pełznąć
Palec mu nieco drżał, kiedy [[ткнул]] paczkę. 	szturchnął
Znany był z tego, że przyjaźnił się z olbrzymimi pająkami, kupował groźne trójgłowe psy od ludzi spotkanych przypadkowo w pubie, a raz przemycił do swojej chatki jajo smoka, co było sprzeczne z prawami [[обязательными]] w świecie czarodziejów.	obowiązującymi
Znany był z tego, że przyjaźnił się z olbrzymimi pająkami, kupował groźne trójgłowe psy od ludzi spotkanych przypadkowo w pubie, a raz [[провёз контрабандой, достал из под полы]] do swojej chatki jajo smoka, co było sprzeczne z prawami obowiązującymi w świecie czarodziejów.	przemycił
Znany był z tego, że przyjaźnił się z olbrzymimi pająkami, kupował groźne trójgłowe psy od ludzi [[встреченых]] przypadkowo w pubie, a raz przemycił do swojej chatki jajo smoka, co było sprzeczne z prawami obowiązującymi w świecie czarodziejów.	spotkanych
Znany był z tego, że [[дружил]] się z olbrzymimi pająkami, kupował groźne trójgłowe psy od ludzi spotkanych przypadkowo w pubie, a raz przemycił do swojej chatki jajo smoka, co było sprzeczne z prawami obowiązującymi w świecie czarodziejów.	przyjaźnił
Rozdarł papier i zobaczył coś zielonego i skórzanego, ale zanim zdołał rozerwać całe opakowanie, paczka zadrżała dziwnie, a wewnątrz coś głośno [[хлопнуло]] — jakby miało szczęki.	kłapnęło
Rozdarł papier i zobaczył coś zielonego i [[кожаного]], ale zanim zdołał rozerwać całe opakowanie, paczka zadrżała dziwnie, a wewnątrz coś głośno kłapnęło — jakby miało szczęki.	skórzanego
Od razu rozpoznał koślawe pismo na brązowym papierze: to paczka od Hagrida, [[егеря, садовника]] Hogwartu. 	gajowego
Jednym z jego największych skarbów była miotła [[гоночная]] Nimbus Dwa Tysiące.Odłożył skórzany neseser i sięgnął po ostatnią paczkę. Od razu rozpoznał koślawe pismo na brązowym papierze: to paczka od Hagrida, gajowego Hogwartu. Rozdarł papier i zobaczył coś zielonego i skórzanego, ale zanim zdołał rozerwać całe opakowanie, paczka zadrżała dziwnie, a wewnątrz coś głośno kłapnęło — jakby miało szczęki.	wyścigowa
Prócz przyjaciół Harry’emu najbardziej brakowało quidditcha, najpopularniejszej dyscypliny sportowej w magicznym świecie — bardzo niebezpiecznej i bardzo [[возбуждая]], w którą grało się na latających miotłach. 	podniecającej
Był tam wielki słój wybornej pasty Fleetwooda do polerowania rączki miotły, para lśniących, srebrnych klipsów do spinania gałązek, maleńki mosiężny kompas z [[держателем]] do rączki, bardzo użyteczny podczas długich lotów, a także Poradnik samodzielnej konserwacji mioteł.	uchwytem
Był tam wielki słój wybornej pasty Fleetwooda do polerowania rączki miotły, para lśniących, srebrnych klipsów do spinania gałązek, maleńki [[латунный]] kompas z uchwytem do rączki, bardzo użyteczny podczas długich lotów, a także Poradnik samodzielnej konserwacji mioteł.	mosiężny
Był tam wielki słój wybornej pasty Fleetwooda do polerowania rączki miotły, para lśniących, srebrnych klipsów do spinania [[прутьев]], maleńki mosiężny kompas z uchwytem do rączki, bardzo użyteczny podczas długich lotów, a także Poradnik samodzielnej konserwacji mioteł.	gałązek
Był tam wielki słój wybornej pasty Fleetwooda do polerowania rączki miotły, para lśniących, srebrnych klipsów do [[закрепления]] gałązek, maleńki mosiężny kompas z uchwytem do rączki, bardzo użyteczny podczas długich lotów, a także Poradnik samodzielnej konserwacji mioteł.	spinania
Był tam wielki słój wybornej pasty Fleetwooda do polerowania rączki miotły, para [[блестящих]], srebrnych klipsów do spinania gałązek, maleńki mosiężny kompas z uchwytem do rączki, bardzo użyteczny podczas długich lotów, a także Poradnik samodzielnej konserwacji mioteł.	lśniących
Był tam wielki słój [[отменной]] pasty Fleetwooda do polerowania rączki miotły, para lśniących, srebrnych klipsów do spinania gałązek, maleńki mosiężny kompas z uchwytem do rączki, bardzo użyteczny podczas długich lotów, a także Poradnik samodzielnej konserwacji mioteł.	wybornej
Serce mu zabiło mocno, kiedy rozerwał papier i ujrzał błyszczący neseser z czarnej skóry, ze srebrnym napisem: „[[подручный]] zestaw miotlarski”.	Podręczny
Jestem teraz na wakacjach we Francji i zupełnie nie wiedziałam, jak ci to wysłać — co by było, gdyby to otworzyli na [[таможне]]? — 	cle
Mam nadzieję, że jakoś z tego [[вышел, выбрался (из ситуации)]].	wybrnąłeś
Przez chwilę Harry przyglądał mu się z [[восторгом]], a potem wziął do ręki paczkę przyniesioną przez Hedwigę.	zachwytem
Szklany bąk sam ustawił się pionowo na spiczastym końcu i tkwił tak nieruchomo, [[отражая]] fosforyzujące wskazówki budzika. 	odbijając
Szklany bąk sam ustawił się pionowo na [[острым]] końcu i tkwił tak nieruchomo, odbijając fosforyzujące wskazówki budzika. 	spiczastym
Bill mówi, że to [[безделушка]] dla turystów, bo wczoraj bąk zaczął ni stąd, ni zowąd błyskać podczas kolacji. 	tandeta
Harry, to jest kieszonkowy fałszoskop — wykrywacz [[подвохов]]. 	podstępów
Harry, to jest [[карманный]] fałszoskop — wykrywacz podstępów. 	kieszonkowy
Wewnątrz było coś, co przypominało miniaturowego [[стеклянного]] bąka do zabawy, i jeszcze jedna karteczka od Rona.	szklanego
W rogowych okularach [[отражалось]] się egipskie słońce.	odbijało
Przypiął sobie odznakę naczelnego prefekta do fezu, tkwiącego mu zawadiacko na głowie, na [[аккуратно]] zaczesanych włosach. 	schludnie
Przypiął sobie odznakę naczelnego prefekta do fezu, tkwiącego mu [[лихо]] na głowie, na schludnie zaczesanych włosach. 	zawadiacko
[[пристегнул]] sobie odznakę naczelnego prefekta do fezu, tkwiącego mu zawadiacko na głowie, na schludnie zaczesanych włosach. 	Przypiął
Percy, który [[начинал]] siódmy, ostatni rok nauki w Hogwarcie, puszył się na nim wyjątkowo. 	rozpoczynał
Harry ponownie [[глянул]] na zdjęcie w gazecie. 	zerknął
Nie daj się [[помять, скомкать]] tym mugolom!	stłamsić
Zdarzyło się to wtedy, kiedy obaj polecieli do Hogwartu samochodem, który przy lądowaniu trafił w drzewo rosnące pośrodku szkolnych [[парка]].	błoni
[[мутировавших]] szkieletów mugoli, którzy włamali się do środka i którym powyrastały dodatkowe głowy i różne inne świństwa.Nie mogłem uwierzyć, że mój tata wygrał w loterii „Proroka”. Siedemset galeonów! Większość poszła na ten wyjazd, ale trochę zostało i rodzice mają mi kupić nową różdżkę.	zmutowanych
Bill [[проводит, показывает (как гид)]] nas po tych wszystkich starożytnych grobowcach, nie masz pojęcia, jakie zaklęcia ich strzegą! 	oprowadza
Nikt chyba nie zasługiwał bardziej na wygranie stosu złotych monet od Weasleyów, którzy byli wspaniałymi ludźmi, a przy tym bardzo [[бедными]]. 	ubogimi
Nikt chyba nie zasługiwał bardziej na wygranie [[груды]] złotych monet od Weasleyów, którzy byli wspaniałymi ludźmi, a przy tym bardzo ubogimi. 	stosu
W samym środku stał Ron, wysoki i szczupły, ze swoim szczurem Parszywkiem na ramieniu, [[обнимая]] młodszą siostrzyczkę, Ginny.	obejmując
[[круглолицая]] pani Weasley, wysoki, łysiejący pan Weasley, sześciu synów i córka — wszyscy (choć na czarnobiałym zdjęciu nie było tego widać) o płomiennorudych włosach. 	Pulchna
Harry rzucił okiem na ruchome zdjęcie i uśmiechnął się szeroko, kiedy zobaczył wszystkich dziewięcioro Weasleyów na tle wielkiej piramidy, [[размахивающий]] do niego rękami. 	wymachujących
Zachwycony pan Weasley powiedział naszemu reporterowi: „Za te pieniądze pojedziemy do Egiptu, gdzie nasz najstarszy syn, Bill, pracuje dla banku Gringotta jako łamacz [[чар, заклятий]]”.	uroków
Ministerstwie Magii, zgarnął najwyższą wygraną w [[ежегодной]] loterii „Proroka Codziennego”.Zachwycony pan Weasley powiedział naszemu reporterowi: „Za te pieniądze pojedziemy do Egiptu, gdzie nasz najstarszy syn, Bill, pracuje dla banku Gringotta jako łamacz uroków”.Rodzina Weasleyów spędzi w Egipcie cały miesiąc. Wrócą na początek nowego roku szkolnego w Hogwarcie, gdzie uczy się pięcioro dzieci Weasleyów.	dorocznej
Na łóżko wypadł list i [[вырезка (из газеты)]] z gazety.	wycinek
Wewnątrz była jego pierwsza w życiu kartka urodzinowa i prezent [[завернутый]] złotą folią. 	owinięty
Wewnątrz był również [[завернутый]] w kolorowy papier prezent, kartka urodzinowa i list, tym razem od Hermiony.	owinięty
Trzeciej sowy, o pięknym brązowym upierzeniu, Harry nigdy przedtem nie widział, ale od razu poznał, skąd przyleciała, bo prócz trzeciej paczki przyniosła list z [[гербом, печатью]] Hogwartu. 	godłem
Kiedy odwiązał paczkę, dziobnęła go przyjacielsko, po czym [[порхнула]] do swojej klatki, sadowiąc się obok Errola.	pofrunęła
Kiedy odwiązał paczkę, [[клевать]] go przyjacielsko, po czym pofrunęła do swojej klatki, sadowiąc się obok Errola.	dziobnęła
Ptak otworzył jedno mętne oko, zagruchał słabo w podzięce i zanurzył dziób w [[миске]] z wodą.	miseczce
Ptak otworzył jedno mętne oko, zagruchał słabo w podzięce i [[погрузил]] dziób w miseczce z wodą.	zanurzył
Ptak otworzył jedno mętne oko, zagruchał słabo w [[благодарность]] i zanurzył dziób w miseczce z wodą.	podzięce
Ptak otworzył jedno mętne oko, [[ворковала]] słabo w podzięce i zanurzył dziób w miseczce z wodą.	zagruchał
Ptak otworzył jedno [[мутное]] oko, zagruchał słabo w podzięce i zanurzył dziób w miseczce z wodą.	mętne
Podbiegł do łóżka, odwiązał sznurek, którym [[примотана, привязана]] była paczka, i zaniósł Errola do klatki Hedwigi. 	przymocowana
Harry natychmiast rozpoznał tego ptaka — był to sędziwy [[филин]] Errol, należący do rodziny Weasleyów. 	puchacz
Harry natychmiast rozpoznał tego ptaka — był to [[почтенный]] puchacz Errol, należący do rodziny Weasleyów. 	sędziwy
Wylądowały z cichym [[шлеп]] na łóżku Harry’ego, a środkowa sowa, wielka i szara, przewróciła się na grzbiet i legła bez ruchu. 	plaśnięciem
Przez okno wleciały trzy sowy, przy czym dwie podtrzymywały trzecią, która sprawiała wrażenie [[потерявшей сознание]]. 	nieprzytomnej
Przez ułamek sekundy zawahał się, z ręką na klamce, czy nie [[захлопнуть]] okna, ale zanim zdążył to zrobić, dziwaczny kształt był już nad jedną z latarni oświetlających Privet Drive i Harry zdał sobie w końcu sprawę, co to jest, więc szybko odskoczył w bok.	zatrzasnąć
Przez ułamek sekundy zawahał się, z ręką na [[ручке (двери, окна)]], czy nie zatrzasnąć okna, ale zanim zdążył to zrobić, dziwaczny kształt był już nad jedną z latarni oświetlających Privet Drive i Harry zdał sobie w końcu sprawę, co to jest, więc szybko odskoczył w bok.	klamce
Zamarł bez ruchu, obserwując, jak dziwny kształt [[летит]] coraz niżej i niżej. 	szybuje
Na tle złotego księżyca czerniało coś wielkiego i [[кривого, косолапого]]. 	koślawego
A kiedy tak patrzył ponad [[крышами]] domów, dopiero po kilku sekundach uświadomił sobie, że zobaczył coś dziwnego.	dachami
Przebiegał spojrzeniem gwiaździste niebo, wypatrując Hedwigi, która w każdej chwili mogła przyfrunąć z martwą myszą w dziobie, [[жаждущая]] pochwały. 	żądna
Przebiegał spojrzeniem gwiaździste niebo, [[высматривая]] Hedwigi, która w każdej chwili mogła przyfrunąć z martwą myszą w dziobie, żądna pochwały. 	wypatrując
Voldemort [[убежал]], ledwo żywy, pozbawiony swej mocy…	umknął
Harry’emu udało się wyjść z tej potyczki jedynie z ową blizną na czole; mordercze zaklęcie Voldemorta odbiło się od niego, [[поразив]] w tego, który je rzucił. 	godząc
Nie była ona, jak mu [[убеждали]] przez dziesięć lat Dursleyowie, pozostałością po wypadku samochodowym, w którym mieli zginąć jego rodzice, ponieważ Lily i James Potterowie wcale nie zginęli w wypadku. 	wmawiali
Sponad okularów połyskiwały jasnozielone oczy, a na czole prześwitywała przez włosy cienka blizna w kształcie [[молнии]].	błyskawicy
Sponad okularów [[светились]] jasnozielone oczy, a na czole prześwitywała przez włosy cienka blizna w kształcie błyskawicy.	połyskiwały
[[сверху]] okularów połyskiwały jasnozielone oczy, a na czole prześwitywała przez włosy cienka blizna w kształcie błyskawicy.	Sponad
Nie zmieniły się jego kruczoczarne włosy — zawsze okropnie [[взъерошенные]], bez względu na to, co z nimi robił. 	rozczochrane
Nie zmieniły się jego [[вороной]] włosy — zawsze okropnie rozczochrane, bez względu na to, co z nimi robił. 	kruczoczarne
Choć w ciągu ubiegłego roku Harry [[вырос]] o parę cali, nadal był dość niski i chudy jak na swój wiek. 	podrósł
Jedną z niezwykłych cech Harry’ego było i to, że nigdy nie wyczekiwał z [[нетерпением]] swoich urodzin. 	utęsknieniem
Jedną z niezwykłych cech Harry’ego było i to, że nigdy nie [[ждал]] z utęsknieniem swoich urodzin. 	wyczekiwał
Potem wyprostował się i przeciągnął, [[поглядывая]] na budzik stojący na nocnej szafce.	zerkając
Zakręcił kałamarz, wyjął spod łóżka starą poszewkę, włożył do niej latarkę, Historię magii, swoje wypracowanie, pióro i kałamarz, wstał z łóżka i ukrył zawiniątko pod [[свободный]] deską podłogi. 	obluzowaną
Zakręcił kałamarz, wyjął spod łóżka starą poszewkę, włożył do niej latarkę, Historię magii, swoje wypracowanie, pióro i kałamarz, wstał z łóżka i ukrył [[сверток]] pod obluzowaną deską podłogi. 	zawiniątko
Zakręcił kałamarz, wyjął spod łóżka starą [[наволочка]], włożył do niej latarkę, Historię magii, swoje wypracowanie, pióro i kałamarz, wstał z łóżka i ukrył zawiniątko pod obluzowaną deską podłogi. 	poszewkę
Harry skończył pisać o czarownicy Wendelinie i przez chwilę [[прислушивался]]. 	nasłuchiwał
Wuj Vernon uległ jego prośbom, bo [[шум]], jaki wyprawiała Hedwiga, kiedy była zamknięta w klatce przez całą dobę, był nie do zniesienia.	harmider
Tylko jedno można było zapisać na plus: po uroczystym [[обещание]], że nie będzie używał swojej sowy Hedwigi do wysyłania listów do któregokolwiek ze swoich przyjaciół, pozwolono mu ją wypuszczać z domu w nocy. 	przyrzeczeniu
Tylko jedno można było zapisać na plus: po [[торжественный]] przyrzeczeniu, że nie będzie używał swojej sowy Hedwigi do wysyłania listów do któregokolwiek ze swoich przyjaciół, pozwolono mu ją wypuszczać z domu w nocy. 	uroczystym
 podejrzewał, że to Ron ją ostrzegł, żeby nie dzwoniła, a szkoda, ponieważ rodzice Hermiony, najinteligentniejszej czarownicy w klasie Harry’ego, byli mugolami, więc musiała dobrze wiedzieć, jak się korzysta z telefonu, no i miała dość rozsądku, by na wstępie nie [[оговориться, брякнуть]], że też jest uczennicą Hogwartu.	palnąć
Ron najwidoczniej zrozumiał, że [[(в)толкнул, вогнал]] Harry’ego w kłopoty, bo już więcej nie zadzwonił. 	wpędził
wrzasnął wuj Vernon, opryskując Harry’ego [[слюной]].	śliną
wrzasnął wuj Vernon, [[обрызгивая]] Harry’ego śliną.	opryskując
[[вскрикнула]] wuj Vernon, opryskując Harry’ego śliną.	wrzasnął
I cisnął słuchawkę na aparat telefoniczny, jakby się [[избавились от]] jadowitego pająka.	pozbywał
Ron wrzeszczał tak głośno, że wuj Vernon aż podskoczył i oddalił słuchawkę od ucha, [[глядя]] się w nią z mieszaniną złości i strachu.	wpatrując
Harry, który akurat był w pokoju, [[напрягся]], kiedy usłyszał głos Rona.	zdrętwiał
Ostatnio bardzo mu zależało na [[уклонение]] awantur, bo ciotka i wuj byli na niego wyjątkowo wściekli, ponieważ w tydzień po przyjeździe na wakacje zatelefonował do niego przyjaciel — a był nim, rzecz jasna, kolega ze Szkoły Magii i Czarodziejstwa.	unikaniu
Musiał tylko uważać, żeby nie [[запятнать]] pościeli atramentem, ponieważ wówczas wszystko by się wydało.Ostatnio bardzo mu zależało na unikaniu awantur, bo ciotka i wuj byli na niego wyjątkowo wściekli, ponieważ w tydzień po przyjeździe na wakacje zatelefonował do niego przyjaciel — a był nim, rzecz jasna, kolega ze Szkoły Magii i Czarodziejstwa.Ron Weasley, jeden z najlepszych przyjaciół Harry’ego, pochodził z rodziny czarodziejów. Oznaczało to, że znał się dobrze na wielu sprawach, o których Harry nie miał zielonego pojęcia, ale jeszcze nigdy w życiu nie korzystał z telefonu. Na nieszczęście trafił na wuja Vernona.	poplamić
Tak się bowiem złożyło, że profesor Snape nie znosił Harry’ego i z najwyższą ochotą [[воспользовался бы]] z każdej okazji, by go ukarać miesięcznym szlabanem. 	skorzystałby
Tym razem miał, między innymi, napisać paskudnie trudne wypracowanie na temat eliksirów powodujących kurczenie się ludzi i zwierząt, a dobrze wiedział, że gdyby zjawił się w Hogwarcie bez tego wypracowania, [[доставил бы]] wielką przyjemność profesorowi Snape’owi, nauczycielowi eliksirów. 	sprawiłby
Tym razem miał, między innymi, napisać paskudnie trudne wypracowanie na temat eliksirów powodujących [[скрючивание]] się ludzi i zwierząt, a dobrze wiedział, że gdyby zjawił się w Hogwarcie bez tego wypracowania, sprawiłby wielką przyjemność profesorowi Snape’owi, nauczycielowi eliksirów. 	kurczenie
Tym razem miał, między innymi, napisać paskudnie trudne wypracowanie na temat eliksirów [[вызывающих]] kurczenie się ludzi i zwierząt, a dobrze wiedział, że gdyby zjawił się w Hogwarcie bez tego wypracowania, sprawiłby wielką przyjemność profesorowi Snape’owi, nauczycielowi eliksirów. 	powodujących
Brak dostępu do ksiąg zaklęć był prawdziwym [[неприятность]] dla Harry’ego, ponieważ uczniowie Hogwartu musieli podczas wakacji odrobić sporo prac domowych. 	utrapieniem
Dwa ostatnie lata Harry spędził w Hogwarcie, Szkole Magii i Czarodziejstwa, wracając na Privet Drive tylko na letnie wakacje, podczas których Dursleyowie żyli w ciągłym strachu, że ktoś z sąsiadów dowie się, jakiego [[урод]] mają pod swoim dachem. 	dziwoląga
Jak dotąd, nie przynosiło to spodziewanego rezultatu, co [[вызванный]] w nich furię. 	wywoływało
Jak dotąd, nie przynosiło to [[ожидаемый]] rezultatu, co wywoływało w nich furię. 	spodziewanego
Ciotka Petunia i wuj Vernon od lat mieli nadzieję, że wybiją Harry’emu magię z głowy, pomiatając nim i karcąc [[браня, ругая]] za byle co. 	bezlitośnie
Ciotka Petunia i wuj Vernon od lat mieli nadzieję, że wybiją Harry’emu magię z głowy, pomiatając nim i [[обличен]] bezlitośnie za byle co. 	karcąc
Ciotka Petunia i wuj Vernon od lat mieli nadzieję, że wybiją Harry’emu magię z głowy, [[унижая]] nim i karcąc bezlitośnie za byle co. 	pomiatając
Powoli i bardzo ostrożnie otworzył butelkę, zanurzył w niej pióro i zaczął pisać, przerywając raz po raz i [[прислушиваясь]], bo wiedział, że gdyby ktoś z rodziny Dursleyów, idąc do łazienki, usłyszał skrzypienie pióra, groziłoby mu zamknięcie w komórce pod schodami na całą resztę lata.	nasłuchując
Harry chwycił pióro w zęby i sięgnął pod poduszkę, gdzie miał schowany [[чернильница]] i zwój pergaminu. 	kałamarz
Ofiary rzucały proste zaklęcie zmrożenia płomieni i udawały, że wrzeszczą z bólu, podczas gdy w rzeczywistości odczuwały przyjemne [[щекотка]]. 	łaskotanie
Ofiary rzucały proste zaklęcie zmrożenia płomieni i [[притворился]], że wrzeszczą z bólu, podczas gdy w rzeczywistości odczuwały przyjemne łaskotanie. 	udawały
Ludzie niemagiczni (znani bardziej jako mugole) lękali się magii szczególnie w czasach średniowiecznych, prawdopodobnie dlatego, że niewiele o niej wiedzieli i nie potrafili rozpoznawać jej [[проявления]]. 	przejawów
Pióro zatrzymało się na początku [[абзаца]], który wzbudził jego zainteresowanie. 	akapitu
W drugiej ręce trzymał swoje orle pióro, którego koniuszkiem wodził po tekście, szukając czegoś, co pomogłoby mu w napisaniu [[сочинения]] na temat: „Palenie czarownic w XIV wieku było całkowicie bezsensowne”.	rozprawki
Dochodziła północ, a Harry leżał na brzuchu w swoim łóżku, pod [[одеяла]] naciągniętymi na głowę jak namiot, z latarką w ręku i wielką, oprawioną w skórę księgą (Historia magii Bathildy Bagshot) opartą o poduszkę. 	kocami
Harry [[обернулся]] w miejscu, skoczył i przygwoździł ją do podłogi. 	okręcił się
Mając nadzieję, że Dursleyowie nadal mocno śpią, Harry [[бросился]] na kolana i sięgnął pod biurko, żeby ją wyciągnąć.	osunął się
Książka [[Соскользнула]] z łóżka, spadła z trzaskiem na podłogę i popełzła po niej szybko. 	zsunęła się
Percy, który rozpoczynał siódmy, ostatni rok nauki w Hogwarcie, [["надувался", важничал]] na nim wyjątkowo. 	puszył się
Przez ułamek sekundy [[колебался]], z ręką na klamce, czy nie zatrzasnąć okna, ale zanim zdążył to zrobić, dziwaczny kształt był już nad jedną z latarni oświetlających Privet Drive i Harry zdał sobie w końcu sprawę, co to jest, więc szybko odskoczył w 	zawahał się
Była jedyną żywą istotą w tym domu, która nie [[тряслась, дрожала]] na jego widok.Choć w ciągu ubiegłego roku Harry podrósł o parę cali, nadal był dość niski i chudy jak na swój wiek. Nie zmieniły się jego kruczoczarne włosy — zawsze okropnie rozczochrane, bez względu na to, co z nimi robił. Sponad okularów połyskiwały jasnozielone oczy, a na czole prześwitywała przez włosy cienka blizna w kształcie błyskawicy.	wzdrygała się
Jeszcze ani razu nie dostał od nikogo kartki [[С Днем Рождения]]. 	z życzeniami urodzinowymi
Potem [[выпрямился]] i przeciągnął, zerkając na budzik stojący na nocnej szafce.	wyprostował się
Tak więc Harry nie miał żadnej wiadomości od swych przyjaciół czarodziejów przez pięć długich tygodni i to lato [[казалось,]] prawie równie podle, jak poprzednie. 	zapowiadało się
Ludzie niemagiczni (znani bardziej jako mugole) [[они боялись]] magii szczególnie w czasach średniowiecznych, prawdopodobnie dlatego, że niewiele o niej wiedzieli i nie potrafili rozpoznawać jej przejawów. 	lękali się